Columns: 40
Rows: 25
TileSize: 32
TileCount: 31

TileDefinition
Type: 0
Collision: 0
MovementCost: 0
Damage: 0

TileDefinition
Type: 1
Collision: 1
MovementCost: 0
Damage: 0

TileDefinition
Type: 2
Collision: 0
MovementCost: 1
Damage: 0

TileDefinition
Type: 3
Collision: 0
MovementCost: 2
Damage: 0

TileDefinition
Type: 4
Collision: 0
MovementCost: 3
Damage: 0

TileDefinition
Type: 5
Collision: 1
MovementCost: 0
Damage: 0

TileDefinition
Type: 6
Collision: 1
MovementCost: 0
Damage: 0

TileDefinition
Type: 7
Collision: 1
MovementCost: 0
Damage: 0

TileDefinition
Type: 8
Collision: 1
MovementCost: 0
Damage: 0

TileDefinition
Type: 9
Collision: 1
MovementCost: 0
Damage: 0

TileDefinition
Type: 10
Collision: 1
MovementCost: 0
Damage: 0

TileDefinition
Type: 11
Collision: 1
MovementCost: 0
Damage: 0

TileDefinition
Type: 12
Collision: 0
MovementCost: 0
Damage: 0

TileDefinition
Type: 13
Collision: 1
MovementCost: 0
Damage: 0

TileDefinition
Type: 14
Collision: 1
MovementCost: 0
Damage: 0

TileDefinition
Type: 15
Collision: 1
MovementCost: 0
Damage: 0

TileDefinition
Type: 16
Collision: 1
MovementCost: 0
Damage: 0

TileDefinition
Type: 17
Collision: 1
MovementCost: 0
Damage: 0

TileDefinition
Type: 18
Collision: 0
MovementCost: 0
Damage: 0

TileDefinition
Type: 19
Collision: 1
MovementCost: 0
Damage: 0

TileDefinition
Type: 20
Collision: 1
MovementCost: 0
Damage: 0

TileDefinition
Type: 21
Collision: 0
MovementCost: 0
Damage: 0

TileDefinition
Type: 22
Collision: 1
MovementCost: 0
Damage: 0

TileDefinition
Type: 23
Collision: 1
MovementCost: 0
Damage: 0

TileDefinition
Type: 24
Collision: 1
MovementCost: 0
Damage: 0

TileDefinition
Type: 25
Collision: 0
MovementCost: 0
Damage: 0

TileDefinition
Type: 26
Collision: 0
MovementCost: 0
Damage: 0

TileDefinition
Type: 27
Collision: 1
MovementCost: 0
Damage: 0

TileDefinition
Type: 28
Collision: 1
MovementCost: 0
Damage: 10

TileDefinition
Type: 29
Collision: 1
MovementCost: 0
Damage: 0

TileDefinition
Type: 30
Collision: 1
MovementCost: 0
Damage: 0

Map
01,01,01,01,01,01,01,01,01,01,01,01,01,01,01,01,01,01,01,01,01,01,01,01,01,01,01,01,01,01,01,01,01,01,01,01,01,01,01,01
01,05,06,06,06,07,29,26,14,15,14,15,14,15,00,26,00,14,15,14,15,14,15,00,26,00,14,15,14,15,14,15,00,26,00,00,00,00,00,01
01,08,00,00,00,10,29,26,16,17,16,17,16,17,00,26,00,16,17,16,17,16,17,00,26,00,16,17,16,17,16,17,00,26,00,00,00,00,00,01
01,08,00,00,00,10,29,26,18,19,19,19,19,18,20,26,00,18,19,19,19,19,18,20,26,00,18,19,19,19,19,18,20,26,00,00,00,00,00,01
01,08,00,00,00,10,29,26,26,26,26,26,26,26,26,26,26,26,26,26,26,26,26,26,26,26,26,26,26,26,26,26,26,26,00,00,00,00,00,01
01,11,11,12,13,13,20,26,26,26,26,26,26,26,26,26,26,26,26,26,26,26,26,26,26,26,26,26,26,26,26,26,26,26,00,00,00,00,00,01
01,30,30,26,26,26,26,26,05,06,06,06,07,00,26,26,00,05,06,06,06,06,07,00,26,26,00,05,06,06,06,07,00,26,00,00,00,00,00,01
01,28,28,28,28,28,26,26,08,00,00,00,10,00,26,26,00,08,00,00,00,00,10,00,26,26,00,08,00,00,00,10,00,26,00,00,00,00,00,01
01,28,00,00,00,28,26,26,08,00,09,00,10,00,26,26,00,08,00,00,00,00,10,00,26,26,00,08,00,09,00,10,00,26,00,00,00,00,00,01
01,28,00,00,00,00,26,26,08,00,00,00,10,00,26,26,00,08,00,00,00,00,10,00,26,26,00,08,00,00,00,10,00,26,00,00,00,00,00,01
01,28,00,00,00,28,26,26,11,11,12,13,13,20,26,26,00,11,12,13,11,12,13,20,26,26,00,11,11,12,13,13,20,26,00,00,00,00,00,01
01,28,28,28,28,28,26,26,26,26,26,26,26,26,26,26,26,26,26,26,26,26,26,26,26,26,26,26,26,26,26,26,26,26,00,00,00,00,00,01
01,00,00,00,00,00,00,00,00,00,00,00,00,00,00,00,00,00,00,00,00,00,00,00,00,00,00,00,00,00,00,00,00,00,00,00,00,00,00,01
01,00,00,00,00,00,00,00,00,00,00,00,00,00,00,00,00,00,00,00,00,00,00,00,00,00,00,00,00,00,00,00,00,00,00,00,00,00,20,01
27,04,03,03,04,03,03,03,03,04,03,03,03,02,02,02,02,02,02,02,02,02,02,02,03,03,03,02,02,02,02,03,04,04,22,22,25,25,22,22
27,04,03,04,27,04,03,03,04,27,04,02,02,03,03,03,03,04,04,04,04,03,03,03,03,03,02,02,02,02,03,04,22,22,22,22,25,25,22,22
27,04,04,04,04,04,03,03,04,04,03,04,27,04,03,03,04,04,04,04,04,03,03,03,04,03,02,02,02,03,04,22,22,22,22,22,25,25,22,22
27,04,27,27,04,27,04,04,27,04,04,03,03,04,03,04,04,27,04,27,04,04,03,04,27,04,02,02,02,03,04,22,22,23,22,22,25,25,22,22
27,04,27,04,04,04,04,03,04,04,27,04,04,27,04,04,27,27,27,27,27,04,04,03,04,03,02,02,02,03,00,22,22,22,22,22,25,25,22,22
27,04,04,04,27,27,04,04,03,03,04,04,03,04,04,27,27,27,27,27,27,27,04,03,03,03,02,02,03,04,22,22,24,22,22,22,02,02,02,27
27,27,04,27,27,04,04,27,04,03,04,27,04,04,03,04,27,27,27,27,27,04,03,02,02,02,02,02,03,22,22,22,22,22,22,03,03,03,03,27
27,27,04,27,04,04,04,04,03,04,03,04,04,27,04,03,04,27,27,27,04,03,04,02,02,02,02,02,00,25,25,25,25,25,02,03,03,03,03,27
27,04,04,04,04,04,04,03,04,27,04,04,03,04,03,03,03,04,27,04,03,04,27,04,02,02,02,02,00,25,25,25,25,25,02,03,03,04,04,27
27,27,04,27,27,27,27,04,04,04,04,27,04,04,04,04,04,04,04,04,04,04,04,04,04,04,04,04,20,22,22,22,22,22,02,03,03,04,04,27
27,27,27,27,27,27,27,27,27,27,27,27,27,27,27,27,27,27,27,27,27,27,27,27,27,27,27,27,27,22,22,22,22,22,27,27,27,27,27,27